5 7 2
#######
#     #
# # # #
#  *  #
#######