5 5 2
#####
#   #
# # #
#*  #
#####
15 10 5
##########
#        #
# #### # #
#   ## # #
### ## # #
#.# ## # #
#.#    # #
### #### #
#    *   #
#   ## ###
#   ##   #
#       ##
####     #
#..#     #
##########